000000000400000000000
000000000200000000000
000000000100000000000
000000000100000000000
000000000100000000000
000000000511110000000
000000000100010000000
000000000100010000000
001000111500010000000
001000100101150000000
001000100101010111000
005111100101010101000
001000011101011101000
001000010000000001000
001000110011111115000
001011100010000001000
001010000010000001000
001011111010000115000
001000001010000101000
001111101310000101000
000000000000000000000
